{
    "entrance": [0, 0],
    "exit": [7, 4],
    "blocks": [
        [0, 0, 2, 2, "#123434"],
        [2, 0, 6, 1, "#0000ff"],
        [2, 1, 2, 2, "#abc123"],
        [0, 2, 2, 6, "#cba321"],
        [4, 1, 1, 1, "#123abc"],
        [5, 3, 4, 1, "#dfdfdf"]
    ]
}
